"Name","EX","EW","Subtotal (EX+EW)","CR(PE)","CR(PEW)","Subtotal (EX+EW+ CR(PE)+CR(PEW))","CR","EN","VU","Subtotal (threatened spp.)","LR/cd","NT or LR/nt","LC or LR/lc","DD","Total"
"Antarctica","0","0","0","0","0","0","0","1","7","8","0","5","162","35","210"
"Bouvet Island","0","0","0","0","0","0","0","0","2","2","0","0","94","3","99"
"French Southern Territories","1","0","1","1","0","2","7","11","18","36","0","8","983","56","1,084"
"Heard Island and McDonald Islands","0","0","0","0","0","0","0","4","9","13","0","1","126","7","147"
"South Georgia and the South Sandwich Islands","0","0","0","0","0","0","0","4","5","9","0","7","195","13","224"
"Anguilla","1","0","1","0","0","1","9","20","43","72","0","21","1,153","66","1,313"
"Antigua and Barbuda","3","0","3","0","0","3","12","21","44","77","0","26","1,257","66","1,429"
"Aruba","0","0","0","0","0","0","7","18","37","62","0","24","1,095","53","1,234"
"Bahamas","2","0","2","1","0","3","14","33","58","105","0","39","1,709","115","1,970"
"Barbados","1","0","1","3","0","4","13","22","42","77","0","28","1,264","68","1,438"
"Bermuda","9","0","9","1","1","11","31","16","33","80","0","23","930","69","1,111"
"Bonaire, Sint Eustatius and Saba","1","0","1","0","0","1","11","18","50","79","0","27","1,247","74","1,428"
"Cayman Islands","1","0","1","0","0","1","12","27","35","74","0","32","1,170","70","1,347"
"Cuba","7","0","7","3","0","10","38","92","87","217","0","70","1,798","144","2,236"
"Curaçao","0","0","0","0","0","0","10","20","40","70","0","24","1,147","77","1,318"
"Dominica","1","0","1","1","0","2","11","25","44","80","0","32","1,292","69","1,474"
"Dominican Republic","8","0","8","10","0","18","44","95","84","223","0","68","1,485","79","1,863"
"Grenada","0","0","0","0","0","0","11","20","46","77","0","26","1,261","70","1,434"
"Guadeloupe","7","0","7","5","0","12","17","28","49","94","0","35","1,234","68","1,438"
"Haiti","9","0","9","18","0","27","104","70","82","256","0","57","1,424","76","1,822"
"Jamaica","3","0","3","5","0","8","25","51","59","135","0","43","1,355","76","1,612"
"Martinique","6","0","6","3","0","9","11","24","35","70","0","27","1,190","59","1,352"
"Montserrat","0","0","0","1","0","1","9","19","43","71","0","25","1,152","57","1,305"
"Puerto Rico","5","0","5","6","0","11","19","33","48","100","0","41","1,492","85","1,723"
"Saint Barthélemy","0","0","0","0","0","0","6","15","34","55","0","15","821","38","929"
"Saint Kitts and Nevis","1","0","1","0","0","1","10","17","45","72","0","26","1,205","63","1,367"
"Saint Lucia","3","0","3","0","0","3","10","29","42","81","0","28","1,251","60","1,423"
"Saint Martin (French part)","0","0","0","1","0","1","9","17","43","69","0","17","1,046","64","1,196"
"Saint Vincent and the Grenadines","1","0","1","0","0","1","9","24","46","79","0","28","1,282","67","1,457"
"Sint Maarten (Dutch part)","0","0","0","1","0","1","9","17","43","69","0","15","1,023","57","1,164"
"Trinidad and Tobago","0","0","0","0","0","0","15","25","57","97","1","40","1,969","89","2,196"
"Turks and Caicos Islands","0","0","0","0","0","0","7","21","45","73","0","28","1,169","66","1,336"
"Virgin Islands, British","0","0","0","2","0","2","14","22","47","83","0","28","1,268","72","1,451"
"Virgin Islands, U.S.","1","0","1","5","0","6","11","23","39","73","0","28","1,253","71","1,426"
"China","6","3","9","14","0","23","124","213","354","691","1","266","4,696","1,099","6,762"
"Hong Kong","0","0","0","1","0","1","12","29","52","93","1","33","1,013","96","1,236"
"Japan","14","1","15","1","0","16","62","179","292","533","3","285","3,566","501","4,903"
"Korea, Democratic People's Republic of","1","0","1","0","0","1","10","31","67","108","0","37","831","72","1,049"
"Korea, Republic of","1","0","1","0","0","1","16","44","82","142","0","56","1,359","120","1,678"
"Macao","0","0","0","0","0","0","5","12","15","32","0","4","426","32","494"
"Mongolia","0","0","0","0","0","0","5","9","25","39","0","29","603","12","683"
"Taiwan, Province of China","0","0","0","0","0","0","30","82","234","346","2","224","3,133","321","4,026"
"Åland Islands","0","0","0","0","0","0","0","0","0","0","0","0","25","1","26"
"Albania","1","0","1","0","0","1","26","52","78","156","0","89","1,074","73","1,393"
"Andorra","0","0","0","0","0","0","0","5","10","15","0","23","329","7","374"
"Austria","3","0","3","4","0","7","31","61","53","145","0","92","922","69","1,231"
"Belgium","1","0","1","0","0","1","7","10","37","54","0","52","767","39","913"
"Bosnia and Herzegovina","0","0","0","0","0","0","15","48","69","132","0","68","966","88","1,254"
"Bulgaria","0","0","0","0","0","0","22","32","76","130","0","90","1,012","70","1,302"
"Croatia","1","0","1","2","0","3","44","58","115","217","0","101","1,273","118","1,710"
"Czechia","0","0","0","0","0","0","4","26","34","64","0","60","767","42","933"
"Denmark","0","0","0","0","0","0","8","7","45","60","0","47","732","31","870"
"Estonia","0","0","0","0","0","0","2","4","20","26","0","28","538","9","601"
"Faroe Islands","1","0","1","0","0","1","5","5","19","29","0","16","310","19","375"
"Finland","0","0","0","0","0","0","5","5","24","34","0","43","576","15","668"
"France","8","0","8","7","0","15","40","116","194","350","0","178","2,060","282","2,878"
"Germany","4","0","4","5","0","9","25","63","71","159","0","97","1,023","82","1,365"
"Gibraltar","0","0","0","0","0","0","9","10","41","60","0","27","543","31","661"
"Greece","4","0","4","10","1","15","92","159","264","515","0","165","1,605","261","2,550"
"Greenland","1","0","1","0","0","1","2","5","20","27","0","9","219","19","275"
"Guernsey","0","0","0","0","0","0","1","1","14","16","0","3","201","12","232"
"Holy See (Vatican City State)","0","0","0","0","0","0","0","0","2","2","0","3","23","2","30"
"Hungary","0","0","0","0","0","0","12","29","44","85","0","59","747","47","938"
"Iceland","1","0","1","0","0","1","5","7","22","34","0","21","359","26","441"
"Ireland","1","0","1","0","0","1","11","10","42","63","0","39","805","64","972"
"Isle of Man","0","0","0","0","0","0","1","2","5","8","0","3","80","6","97"
"Italy","3","0","3","6","0","9","62","148","198","408","0","215","1,712","256","2,594"
"Jersey","0","0","0","0","0","0","1","1","15","17","0","2","209","12","240"
"Latvia","0","0","0","0","0","0","2","6","29","37","0","39","582","16","674"
"Liechtenstein","0","0","0","0","0","0","0","3","7","10","0","25","424","8","467"
"Lithuania","0","0","0","0","0","0","2","4","23","29","0","35","564","15","643"
"Luxembourg","0","0","0","0","0","0","2","3","7","12","0","23","482","12","529"
"Malta","0","0","0","0","0","0","12","13","41","66","0","28","572","43","709"
"Monaco","0","0","0","0","0","0","10","9","30","49","0","15","394","26","484"
"Montenegro","1","0","1","0","0","1","25","65","69","159","0","90","1,057","78","1,385"
"Netherlands","1","0","1","0","0","1","9","6","40","55","0","57","806","37","956"
"North Macedonia","2","0","2","2","0","4","20","45","69","134","0","61","767","50","1,014"
"Norway","0","0","0","0","0","0","10","12","46","68","0","53","710","29","860"
"Poland","1","0","1","0","0","1","3","24","42","69","0","60","813","37","980"
"Portugal","6","0","6","17","0","23","116","121","160","397","0","163","1,752","313","2,631"
"Romania","2","0","2","3","0","5","25","54","79","158","0","80","995","76","1,311"
"San Marino","0","0","0","0","0","0","1","0","4","5","0","5","66","4","80"
"Serbia","0","0","0","0","0","0","15","40","54","109","0","65","901","27","1,102"
"Slovakia","0","0","0","0","0","0","11","23","39","73","0","64","779","45","961"
"Slovenia","0","0","0","0","0","0","18","47","118","183","0","62","1,145","83","1,473"
"Spain","2","0","2","11","0","13","88","186","255","529","0","292","2,253","486","3,562"
"Svalbard and Jan Mayen","0","0","0","0","0","0","0","1","10","11","0","6","77","3","97"
"Sweden","0","0","0","0","0","0","6","9","42","57","0","60","735","32","884"
"Switzerland","6","0","6","0","0","6","6","45","59","110","0","81","861","60","1,118"
"United Kingdom","4","0","4","2","0","6","21","22","70","113","0","68","1,044","64","1,293"
"Belize","1","0","1","0","0","1","11","38","68","117","0","56","2,117","94","2,385"
"Costa Rica","4","0","4","9","0","13","41","94","167","302","0","117","3,523","242","4,188"
"El Salvador","0","0","0","0","0","0","9","29","64","102","0","47","1,638","85","1,872"
"Guatemala","3","0","3","5","0","8","48","103","140","291","0","83","2,883","168","3,428"
"Honduras","4","0","4","10","0","14","68","93","121","282","0","91","3,101","158","3,636"
"Mexico","22","9","31","36","3","70","214","361","379","954","1","241","5,101","595","6,923"
"Nicaragua","1","0","1","0","0","1","27","41","108","176","0","84","3,008","161","3,430"
"Panama","2","0","2","8","1","11","56","95","141","292","0","129","3,646","304","4,373"
"Algeria","2","1","3","0","4","7","31","50","85","166","0","57","975","130","1,331"
"Egypt","1","1","2","0","0","2","21","45","139","205","2","131","1,829","176","2,345"
"Libya","0","1","1","0","0","1","17","21","51","89","0","31","729","60","910"
"Morocco","7","0","7","0","0","7","42","78","114","234","0","79","1,509","165","1,994"
"Tunisia","13","0","13","1","0","14","26","31","68","125","0","52","886","90","1,166"
"Western Sahara","0","1","1","0","0","1","13","28","52","93","0","39","963","95","1,191"
"Canada","9","0","9","3","0","12","18","37","100","155","0","74","1,994","95","2,327"
"Saint Pierre and Miquelon","0","0","0","0","0","0","2","5","17","24","0","14","384","17","439"
"United States","231","4","235","36","0","271","244","330","592","1,166","5","340","5,919","648","8,313"
"Belarus","0","0","0","0","0","0","3","5","24","32","0","36","497","8","573"
"Moldova","1","0","1","0","0","1","9","7","23","39","0","30","455","6","531"
"Russian Federation","3","1","4","2","0","6","40","54","132","226","0","129","2,004","239","2,602"
"Ukraine","2","0","2","1","0","3","16","34","60","110","0","71","933","75","1,191"
"American Samoa","1","0","1","0","0","1","3","21","82","106","3","80","1,272","59","1,521"
"Australia","41","0","41","7","0","48","155","293","666","1,114","3","452","6,000","703","8,313"
"Christmas Island","4","2","6","1","0","7","2","20","38","60","0","26","949","33","1,074"
"Cocos (Keeling) Islands","0","0","0","0","0","0","1","16","37","54","0","25","848","32","959"
"Cook Islands","15","0","15","0","0","15","1","16","55","72","1","51","1,032","52","1,223"
"Fiji","1","0","1","6","0","7","28","59","179","266","3","161","1,860","137","2,428"
"French Polynesia","59","11","70","2","0","72","43","26","78","147","2","59","1,310","111","1,699"
"Guam","5","1","6","0","0","6","8","26","78","112","2","98","1,242","107","1,567"
"Kiribati","1","0","1","0","0","1","0","17","104","121","3","116","1,296","66","1,603"
"Marshall Islands","0","0","0","0","0","0","1","16","100","117","3","116","1,345","65","1,646"
"Micronesia, Federated States of","2","0","2","1","0","3","7","31","148","186","3","147","1,679","129","2,146"
"Nauru","0","0","0","0","0","0","1","11","85","97","0","109","1,040","41","1,287"
"New Caledonia","5","0","5","3","0","8","44","70","171","285","3","157","2,236","193","2,879"
"New Zealand","23","0","23","8","0","31","46","81","125","252","0","64","1,091","210","1,640"
"Niue","0","0","0","0","0","0","1","14","48","63","0","52","892","36","1,043"
"Norfolk Island","8","0","8","0","0","8","2","12","43","57","0","23","645","28","761"
"Northern Mariana Islands","2","0","2","0","0","2","7","25","77","109","3","104","1,311","73","1,602"
"Palau","1","0","1","13","0","14","28","37","135","200","4","148","1,936","113","2,402"
"Papua New Guinea","1","0","1","2","0","3","65","98","318","481","3","293","4,289","577","5,644"
"Pitcairn","0","0","0","0","0","0","1","7","36","44","1","23","527","28","623"
"Samoa","2","0","2","0","0","2","4","20","81","105","3","82","1,371","79","1,642"
"Solomon Islands","2","0","2","3","0","5","16","41","198","255","3","201","2,286","149","2,896"
"Tokelau","0","0","0","0","0","0","1","13","51","65","2","56","908","36","1,067"
"Tonga","3","0","3","2","0","5","13","24","78","115","3","68","1,449","62","1,700"
"Tuvalu","0","0","0","0","0","0","2","15","91","108","3","111","1,102","48","1,372"
"United States Minor Outlying Islands","1","0","1","0","0","1","4","9","67","80","1","74","1,246","55","1,457"
"Vanuatu","1","0","1","0","0","1","2","24","122","148","3","133","1,853","97","2,235"
"Wallis and Futuna","0","0","0","0","0","0","2","14","81","97","0","92","1,222","51","1,462"
"Argentina","3","3","6","6","0","12","50","98","142","290","0","130","2,411","188","3,025"
"Bolivia, Plurinational States of","0","0","0","9","0","9","34","33","86","153","2","94","2,533","137","2,919"
"Brazil","11","2","13","28","0","41","240","326","448","1,014","9","355","7,631","1,216","10,238"
"Chile","1","0","1","3","0","4","24","65","87","176","0","83","1,315","204","1,779"
"Colombia","1","0","1","43","0","44","124","255","384","763","2","277","5,781","601","7,425"
"Ecuador","8","0","8","47","0","55","125","196","299","620","2","206","3,791","390","5,017"
"Falkland Islands (Malvinas)","1","0","1","0","0","1","0","8","11","19","0","10","281","17","328"
"French Guiana","0","0","0","0","0","0","13","24","57","94","1","40","2,350","106","2,591"
"Guyana","0","0","0","0","0","0","12","43","77","132","2","54","2,593","114","2,895"
"Paraguay","0","3","3","2","0","5","6","13","37","56","0","62","1,233","41","1,395"
"Peru","1","0","1","10","0","11","56","159","213","428","2","199","4,241","488","5,359"
"Suriname","0","0","0","0","0","0","10","31","53","94","0","51","2,463","109","2,717"
"Uruguay","2","0","2","2","0","4","23","39","61","123","0","52","1,062","64","1,303"
"Venezuela, Bolivarian Republic of","2","0","2","25","0","27","111","170","230","511","1","208","4,303","371","5,396"
"Bangladesh","0","0","0","0","0","0","39","71","89","199","0","85","1,700","106","2,090"
"Bhutan","0","0","0","0","0","0","8","20","40","68","0","50","769","10","897"
"British Indian Ocean Territory","0","0","0","0","0","0","3","17","83","103","2","102","1,068","46","1,321"
"Brunei Darussalam","0","0","0","0","0","0","13","59","104","176","0","130","1,661","92","2,059"
"Cambodia","0","0","0","1","0","1","42","79","174","295","0","176","2,253","196","2,920"
"Disputed Territory","0","0","0","0","0","0","1","7","15","23","0","5","1,113","35","1,176"
"India","0","0","0","6","0","6","115","286","426","827","2","359","4,598","948","6,734"
"Indonesia","3","0","3","23","3","29","193","371","676","1,240","4","679","6,718","1,527","10,171"
"Lao People's Democratic Republic","1","0","1","2","0","3","44","60","104","208","0","98","1,592","234","2,133"
"Malaysia","1","0","1","13","0","14","107","210","457","774","3","449","4,332","509","6,068"
"Maldives","0","0","0","0","0","0","6","28","63","97","2","94","1,360","73","1,626"
"Myanmar","0","0","0","1","0","1","48","104","190","342","3","276","3,343","444","4,408"
"Nepal","0","0","0","0","0","0","15","33","61","109","0","75","1,343","69","1,596"
"Philippines","15","0","15","8","0","23","63","212","433","708","4","354","3,814","639","5,534"
"Singapore","1","0","1","1","0","2","24","61","219","304","3","231","1,947","159","2,645"
"Sri Lanka","18","0","18","5","0","23","118","212","201","531","2","179","2,134","168","3,032"
"Thailand","2","0","2","5","0","7","65","148","352","565","2","374","4,127","539","5,609"
"Timor-Leste","0","0","0","0","0","0","7","21","28","56","0","39","1,478","65","1,638"
"Viet Nam","1","0","1","9","0","10","93","206","317","616","2","262","3,577","680","5,138"
"Angola","0","0","0","0","0","0","25","55","89","169","0","68","2,938","212","3,387"
"Benin","0","0","0","0","0","0","27","36","60","123","0","56","1,918","95","2,192"
"Botswana","0","0","0","0","0","0","5","11","18","34","0","24","1,338","7","1,403"
"Burkina Faso","0","1","1","0","0","1","9","13","14","36","0","23","930","9","999"
"Burundi","0","0","0","0","0","0","7","20","34","61","0","36","1,172","37","1,306"
"Cabo Verde","2","0","2","0","0","2","13","27","45","85","0","31","922","91","1,131"
"Cameroon","0","0","0","6","0","6","82","135","129","346","0","85","2,962","203","3,596"
"Central African Republic","0","0","0","0","0","0","11","16","26","53","0","31","1,596","54","1,734"
"Chad","0","1","1","1","0","2","12","14","25","51","0","24","945","13","1,034"
"Comoros","0","0","0","1","0","1","9","37","95","141","0","119","1,385","88","1,733"
"Congo","0","0","0","0","0","0","19","35","75","129","0","52","2,214","132","2,527"
"Congo, The Democratic Republic of the","0","0","0","4","0","4","41","98","173","312","0","112","4,099","412","4,935"
"Côte d'Ivoire","0","0","0","2","0","2","30","59","95","184","0","91","2,252","124","2,651"
"Djibouti","0","0","0","0","0","0","12","23","94","129","0","120","1,508","116","1,873"
"Equatorial Guinea","0","0","0","0","0","0","22","45","64","131","0","48","1,689","106","1,974"
"Eritrea","0","0","0","0","0","0","18","38","105","161","0","135","1,700","120","2,116"
"Eswatini","0","0","0","0","0","0","5","10","20","35","0","26","1,123","5","1,189"
"Ethiopia","0","0","0","3","0","3","19","46","63","128","0","52","1,657","76","1,913"
"Gabon","0","0","0","0","0","0","19","46","76","141","0","56","2,262","153","2,612"
"Gambia","0","0","0","0","0","0","26","37","66","129","0","52","1,667","102","1,950"
"Ghana","0","0","0","2","0","2","40","45","89","174","0","86","2,350","117","2,727"
"Guinea","0","0","0","1","0","1","30","65","113","208","0","81","2,227","134","2,650"
"Guinea-Bissau","0","0","0","0","0","0","24","32","63","119","0","52","1,629","99","1,899"
"Kenya","2","0","2","18","0","20","57","83","173","313","2","188","3,744","262","4,511"
"Lesotho","0","0","0","0","0","0","0","7","9","16","0","19","505","3","543"
"Liberia","0","0","0","2","0","2","32","51","80","163","0","73","1,929","114","2,279"
"Madagascar","13","0","13","10","0","23","158","363","353","874","2","327","2,501","473","4,190"
"Malawi","1","0","1","4","0","5","29","28","36","93","0","65","1,800","60","2,019"
"Mali","0","1","1","0","0","1","8","14","25","47","0","27","1,069","12","1,156"
"Mauritania","0","1","1","0","0","1","24","39","79","142","0","55","1,507","109","1,814"
"Mauritius","46","0","46","1","0","47","19","50","125","194","2","114","1,518","144","2,018"
"Mayotte","5","0","5","0","0","5","4","26","89","119","0","113","1,225","63","1,525"
"Mozambique","1","0","1","2","0","3","26","69","160","255","2","190","3,672","230","4,350"
"Namibia","1","0","1","0","0","1","15","35","58","108","0","52","2,146","92","2,399"
"Niger","0","1","1","0","0","1","8","13","21","42","0","23","818","6","890"
"Nigeria","0","1","1","3","0","4","41","73","97","211","0","81","2,735","138","3,166"
"Réunion","21","0","21","1","0","22","11","29","99","139","0","101","1,331","96","1,688"
"Rwanda","1","0","1","0","0","1","12","20","31","63","0","34","1,165","19","1,282"
"Saint Helena, Ascension and Tristan da Cunha","29","0","29","12","0","41","48","59","41","148","0","17","615","53","862"
"Sao Tome and Principe","0","0","0","0","0","0","10","26","36","72","0","19","767","96","954"
"Senegal","0","1","1","0","0","1","29","56","85","170","0","68","2,029","134","2,402"
"Seychelles","20","0","20","29","0","49","89","161","158","408","2","124","1,659","115","2,328"
"Sierra Leone","0","0","0","1","0","1","29","46","85","160","0","78","1,993","126","2,357"
"Somalia","0","0","0","1","0","1","17","39","118","174","0","143","2,495","230","3,042"
"South Africa","8","0","8","5","0","13","88","201","230","519","2","230","4,289","346","5,394"
"South Sudan","0","0","0","0","0","0","8","16","25","49","0","23","1,282","21","1,375"
"Sudan","0","1","1","0","0","1","20","34","107","161","0","129","2,290","137","2,718"
"Tanzania, United Republic of","2","1","3","61","1","65","128","173","274","575","0","236","4,380","379","5,573"
"Togo","0","0","0","1","0","1","30","31","60","121","0","56","1,916","93","2,186"
"Uganda","0","0","0","28","0","28","48","43","87","178","0","68","2,162","126","2,534"
"Zambia","0","0","0","0","0","0","11","29","41","81","0","42","2,151","74","2,348"
"Zimbabwe","0","0","0","1","0","1","10","17","31","58","0","32","1,729","26","1,845"
"Afghanistan","0","0","0","0","0","0","4","13","35","52","0","31","667","21","771"
"Armenia","0","0","0","0","0","0","7","9","26","42","0","40","485","18","585"
"Azerbaijan","0","1","1","2","0","3","18","14","30","62","0","43","600","45","751"
"Bahrain","0","0","0","0","0","0","11","15","39","65","0","55","664","32","816"
"Cyprus","0","0","0","1","0","1","14","28","45","87","0","40","672","62","861"
"Georgia","0","0","0","0","0","0","14","10","38","62","0","50","614","24","750"
"Iran, Islamic Republic of","0","1","1","1","0","2","31","51","105","187","0","106","1,799","163","2,256"
"Iraq","0","0","0","1","0","1","13","20","65","98","0","73","987","48","1,206"
"Israel","4","0","4","0","0","4","28","51","132","211","0","136","1,661","152","2,164"
"Jordan","0","0","0","0","0","0","5","27","95","127","0","116","1,307","97","1,647"
"Kazakhstan","1","1","2","3","0","5","23","21","44","88","0","35","796","59","980"
"Kuwait","1","0","1","0","0","1","9","18","47","74","0","57","783","35","950"
"Kyrgyzstan","0","0","0","0","0","0","1","13","25","39","0","25","479","14","557"
"Lebanon","0","0","0","0","0","0","13","30","52","95","0","42","752","66","955"
"Oman","0","0","0","0","0","0","14","45","83","142","0","95","1,659","131","2,027"
"Pakistan","0","0","0","0","0","0","27","76","129","232","0","108","1,823","125","2,288"
"Palestine, State of","0","0","0","0","0","0","5","17","23","45","0","24","386","22","477"
"Qatar","0","0","0","0","0","0","12","18","45","75","0","55","689","25","844"
"Saudi Arabia","1","0","1","0","0","1","14","43","116","173","2","141","1,698","152","2,167"
"Syrian Arab Republic","1","0","1","6","0","7","22","41","71","134","0","51","898","85","1,169"
"Tajikistan","0","0","0","2","0","2","6","12","25","43","0","21","485","24","573"
"Turkey","4","0","4","12","0","16","78","112","129","319","0","106","1,349","184","1,962"
"Turkmenistan","0","1","1","1","0","2","16","15","31","62","0","30","608","43","744"
"United Arab Emirates","0","0","0","0","0","0","13","35","53","101","0","60","1,121","58","1,340"
"Uzbekistan","0","0","0","3","0","3","14","13","29","56","0","28","539","21","644"
"Yemen","2","0","2","1","0","3","12","40","124","176","0","156","2,021","188","2,543"